{   
    "maxSpeed" : 90 ,
    "rate": 1,
    "acc": 1,
    "tab": [
        [],
        [727,0,0,0,0,0,0,0,0,0,0,0,0,0,0,0,0,0,0,0,0,0,0,0,0,0,0,0,0,0,0,0,0,0,0,0,0,0,0,0,0,0,0,0,0,727],
        [727,626,0,0,0,0,0,0,0,0,0,0,0,0,0,0,0,0,0,0,0,0,0,0,0,0,0,0,0,0,0,0,0,0,0,0,0,0,626,727],
        [727,626,525,0,0,0,0,0,0,0,0,0,0,0,0,0,0,0,0,0,0,0,0,0,0,0,0,0,0,0,0,525,626,727],
        [727,626,525,424,0,0,0,0,0,0,0,0,0,0,0,0,0,0,0,0,0,0,0,0,424,525,626,727],
        [727,626,525,424,323,0,0,0,0,0,0,0,0,0,0,0,0,323,424,525,626,727],
        [727,626,525,424,323,222,0,0,0,0,222,323,424,525,626,727],
        [727,626,525,424,323,222,29,222,323,424,525,626,727],
        [727,626,525,424,323,222,0,0,0,0,222,323,424,525,626,727],
        [727,626,525,424,323,0,0,0,0,0,0,0,0,0,0,0,0,323,424,525,626,727],
        [727,626,525,424,0,0,0,0,0,0,0,0,0,0,0,0,0,0,0,0,0,0,0,0,424,525,626,727],
        [727,626,525,0,0,0,0,0,0,0,0,0,0,0,0,0,0,0,0,0,0,0,0,0,0,0,0,0,0,0,0,525,626,727],
        [727,626,0,0,0,0,0,0,0,0,0,0,0,0,0,0,0,0,0,0,0,0,0,0,0,0,0,0,0,0,0,0,0,0,0,0,0,0,626,727],
        [727,0,0,0,0,0,0,0,0,0,0,0,0,0,0,0,0,0,0,0,0,0,0,0,0,0,0,0,0,0,0,0,0,0,0,0,0,0,0,0,0,0,0,0,0,727]
    ]
}
