{
    "maxSpeed" : 40 ,
    "rate": 1,
    "acc": 1,
    "tab": [
        [],
        [],
        [21, 21, 21, 21, 21, 21, 21, 21],
        [21, 22, 22, 22, 22, 22, 22, 21],
        [21, 22, 23, 23, 23, 23, 22, 21],
        [21, 22, 22, 22, 22, 22, 22, 21],
        [21, 21, 21, 21, 21, 21, 21, 21]
    ]
}
