{   
    "maxSpeed" : 50 ,
    "rate": 2,
    "acc": 1,
    "tab": [
        [],
        [],
        [21, 0, 0, 0, 0, 21, 0, 0, 0, 0, 21, 0, 0, 0, 0, 21, 0, 0, 0, 0, 21, 0, 0, 0, 0, 21, 0, 0, 0, 0],
        [21, 0, 0, 0, 0, 21, 0, 0, 0, 0, 21, 0, 0, 0, 0, 21, 0, 0, 0, 0, 21, 0, 0, 0, 0, 21, 0, 0, 0, 0],
        [22, 0, 0, 0, 0, 22, 0, 0, 0, 0, 22, 0, 0, 0, 0, 22, 0, 0, 0, 0, 22, 0, 0, 0, 0, 22, 0, 0, 0, 0],
        [23, 0, 0, 0, 0, 23, 0, 0, 0, 0, 23, 0, 0, 0, 0, 23, 0, 0, 0, 0, 23, 0, 0, 0, 0, 23, 0, 0, 0, 0],
        [24, 0, 0, 0, 0, 24, 0, 0, 0, 0, 24, 0, 0, 0, 0, 24, 0, 0, 0, 0, 24, 0, 0, 0, 0, 24, 0, 0, 0, 0],
        [24, 0, 0, 0, 0, 24, 0, 0, 0, 0, 24, 0, 0, 0, 0, 24, 0, 0, 0, 0, 24, 0, 0, 0, 0, 24, 0, 0, 0, 0],
        [327, 0, 0, 0, 0, 327, 0, 0, 0, 0, 327, 0, 0, 0, 0, 327, 0, 0, 0, 0, 327, 0, 0, 0, 0, 327, 0, 0, 0, 0]
    ]
}
