{
    "rate": 1,
    "acc": 1,
    "tab": [
        [],
        [],
        [24, 22, 21, 22, 23, 24, 22, 21],
        [23, 24, 22, 21, 22, 23, 24, 22],
        [22, 23, 24, 22, 21, 22, 23, 24],
        [21, 22, 23, 24, 22, 21, 22, 23],
        [22, 21, 22, 23, 24, 22, 21, 22],
        [19,11,11,19, 24, 29, 227, 227, 29, 24, 19,11,11,19]
    ]
}
