{   "maxSpeed" : 60 ,
    "rate": 1,
    "acc": 1,
    "tab": [
        [],
        [],
        [0,0,0,0,0,0,0,11,11,11,11,11,11,11,11,11,11,11,11,11,11,11,11,11,11,11,11,11,11,11,11,11,11,11,11,11,11,11,11,11,11,0,0,0,0,0,0,0],
        [0,0,0,0,0,0,0,11,227,227,227,227,227,227,227,227,11,0,0,0,0,0,0,0],
        [0,0,0,0,0,0,0,11,327,327,327,327,327,327,327,327,11,0,0,0,0,0,0,0],
        [0,0,0,0,0,0,0,11,227,227,227,227,227,227,227,227,11,0,0,0,0,0,0,0],
        [0,0,0,0,0,0,0,11,11,11,11,11,11,11,11,11,11,11,11,11,11,11,11,11,11,11,11,11,11,11,11,11,11,11,11,11,11,11,11,11,11,0,0,0,0,0,0,0],
        [0,0,0,0,0,0,0,19,29,29,29,29,29,29,29,29,19,0,0,0,0,0,0,0],
        [0,0,0,0,0,0,0,11,11,11,11,11,11,11,11,11,11,11,11,11,11,11,11,11,11,11,11,11,11,11,11,11,11,11,11,11,11,11,11,11,11,0,0,0,0,0,0,0],
        [0,0,0,0,0,0,0,11,227,227,227,227,227,227,227,227,11,0,0,0,0,0,0,0],
        [0,0,0,0,0,0,0,11,327,327,327,327,327,327,327,327,11,0,0,0,0,0,0,0],
        [0,0,0,0,0,0,0,11,227,227,227,227,227,227,227,227,11,0,0,0,0,0,0,0],
        [0,0,0,0,0,0,0,11,11,11,11,11,11,11,11,11,11,11,11,11,11,11,11,11,11,11,11,11,11,11,11,11,11,11,11,11,11,11,11,11,11,0,0,0,0,0,0,0]
    ]
}