{   
    "maxSpeed" : 60 ,
    "rate": 1,
    "acc": 1,
    "tab": [
        [],
        [0,0,0,0,11,11,11,11,11,11,11,0,0,0,0,0,0,0,0,11,11,11,11,11,11,11,0,0,0,0],
        [0,0,0,11,12,12,12,12,12,12,12,11,0,0,0,0,0,0,11,12,12,12,12,12,12,12,11,0,0,0],
        [0,0,11,12,12,12,12,12,12,12,12,12,11,0,0,0,0,11,12,12,12,12,12,12,12,12,12,11,0,0],
        [0,0,11,19,12,12,19,12,19,12,12,19,11,0,0,0,0,11,12,12,19,19,19,19,19,12,12,11,0,0],
        [0,0,11,19,19,12,19,12,19,12,12,19,11,0,0,0,0,11,12,12,12,12,12,12,19,12,12,11,0,0],
        [0,0,11,19,19,19,19,12,19,12,12,19,11,0,0,0,0,11,12,12,12,12,19,19,12,12,12,11,0,0],
        [0,0,11,19,12,19,19,12,19,12,12,19,11,0,0,0,0,11,12,12,12,19,12,12,12,12,12,11,0,0],
        [0,0,11,19,12,12,19,12,12,19,19,12,11,0,0,0,0,11,12,12,12,19,12,12,12,12,12,11,0,0],
        [0,0,11,12,12,12,12,12,12,12,12,12,11,0,0,0,0,11,12,12,12,12,12,12,12,12,12,11,0,0],
        [0,0,0,11,12,12,12,12,12,12,12,11,0,0,0,0,0,0,11,12,12,12,12,12,12,12,11,0,0,0],
        [0,0,0,0,11,11,11,11,11,11,11,0,0,0,0,0,0,0,0,11,11,11,11,11,11,11,0,0,0,0]
    ]
}