{   
    "maxSpeed" : 70 ,
    "rate": 1,
    "acc": 1,
    "tab": [
        [],
        [],
        [0,0,0,0,0,11,11,11,11,11,11,11,11,11,11,11,11,11,11,11,0],
        [0,0,0,0,0,11,0,0,0,0,0,0,0,0,0,0,0,0,0,11,0],
        [0,0,0,0,0,11,0,0,0,0,0,0,0,0,0,0,0,0,11,0,0],
        [0,0,0,0,11,0,0,0,0,0,0,0,0,0,0,0,0,11,0,0,0],
        [0,0,0,0,11,0,0,0,0,0,0,0,0,0,0,0,11,0,0,0,0],
        [0,0,0,0,11,0,0,0,0,0,0,0,0,0,0,11,0,0,0,0,0],
        [0,0,0,11,0,0,0,0,0,0,0,0,0,0,11,0,0,0,0,0,0],
        [0,0,0,11,0,0,0,0,0,0,0,0,0,11,0,0,0,0,0,0,0],
        [0,0,0,11,0,0,0,0,0,0,0,0,11,0,0,0,0,0,0,0,0],
        [0,0,11,0,0,0,0,0,0,0,0,11,0,0,0,0,0,0,0,0,0],
        [0,0,11,0,0,0,0,0,0,0,0,11,11,11,11,0,0,0,0,0,0],
        [0,0,11,11,11,11,11,0,0,0,0,0,0,0,11,0,0,0,0,0,0],
        [0,0,0,0,0,0,11,0,0,0,0,0,0,11,0,0,0,0,0,0,0],
        [0,0,0,0,0,11,0,0,0,0,0,0,11,0,0,0,0,0,0,0,0],
        [0,0,0,0,0,11,0,0,0,0,0,11,0,0,0,0,0,0,0,0,0],
        [0,0,0,0,11,0,0,0,0,0,11,0,0,0,0,0,0,0,0,0,0],
        [0,0,0,0,11,0,0,0,0,11,0,0,0,0,0,0,0,0,0,0,0],
        [0,0,0,11,0,0,0,0,11,0,0,0,0,0,0,0,0,0,0,0,0],
        [0,0,0,11,0,0,0,11,0,0,0,0,0,0,0,0,0,0,0,0,0],
        [0,0,11,0,0,0,11,0,0,0,0,0,0,0,0,0,0,0,0,0,0],
        [0,0,11,0,0,11,0,0,0,0,0,0,0,0,0,0,0,0,0,0,0],
        [0,11,0,0,11,0,0,0,0,0,0,0,0,0,0,0,0,0,0,0,0],
        [0,11,0,11,0,0,0,0,0,0,0,0,0,0,0,0,0,0,0,0,0],
        [0,11,11,0,0,0,0,0,0,0,0,0,0,0,0,0,0,0,0,0,0]
    ]
}
