{   
    "maxSpeed" : 80 ,
    "rate": 2,
    "acc": 1,
    "tab": [
        [],
        [11,11,11,11,11,11,11,11,11,11,11,11,11,11,11,11,11,11,11,11,11,11,11,11,11,11,11,11,11,11],
        [11,11,11,11,11,11,11,11,11,11,11,11,11,11,11,11,11,11,11,11,11,11,11,11,11,11,11,11,11,11],
        [],
        [],
        [0,29,0,0,29,0,0,29,0,0,29,0,0,29,0],
        [0,11,11,11,11,0,0,11,11,11,11,0,0,11,11,11,11,0,0,11,11,11,11,0,0,11,11,11,11,0],
        [0,12,12,12,12,0,0,12,12,12,12,0,0,12,12,12,12,0,0,12,12,12,12,0,0,12,12,12,12,0],
        [0,12,12,12,12,0,0,12,12,12,12,0,0,12,12,12,12,0,0,12,12,12,12,0,0,12,12,12,12,0],
        [0,12,12,12,12,0,0,12,12,12,12,0,0,12,12,12,12,0,0,12,12,12,12,0,0,12,12,12,12,0],
        [0,29,0,0,29,0,0,29,0,0,29,0,0,29,0],
        [],
        [],
        [11,11,11,11,11,11,11,11,11,11,11,11,11,11,11,11,11,11,11,11,11,11,11,11,11,11,11,11,11,11],
        [11,11,11,11,11,11,11,11,11,11,11,11,11,11,11,11,11,11,11,11,11,11,11,11,11,11,11,11,11,11]
    ]
}